20
*****..........*****
*..................*
*..................*
*....**********....*
*..................*
....................
......********......
......*.............
......*.............
......********......
.............*......
.............*......
......********......
....................
....................
*..................*
*....**********....*
*..................*
*..................*
*****..........*****
